111111111
1C0000011
10P0E0001
110C000C1
1C0000011
111111111