111111111
1P0CEC001
1000000C1
111111111
