111111111
1P0CEC001
111111111
