111111111
1PPCEC001
111111111
